LPM = "countries/La Pampa.txt"
BMK = "countries/Bismarckreich.txt"
CDB = "countries/Cordoba.txt"
STF = "countries/Santa Fe.txt"
SLT = "countries/Salta.txt"
ENT = "countries/Entre Rios.txt"
CRR = "countries/Corrientes.txt"
MSN = "countries/Misiones.txt"
STE = "countries/Santiago del Estero.txt"
CHC = "countries/Chaco.txt"
FRM = "countries/Formosa.txt"
MND = "countries/Mendoza.txt"
TCM = "countries/Tucuman.txt"
LRJ = "countries/La Rioja.txt"
CTM = "countries/Catamarca.txt"
SJU = "countries/San Juan.txt"
BAB = "countries/Bahia Blanca.txt"
SLU = "countries/San Luis.txt"
PTG = "countries/Patagonia.txt"
TDF = "countries/Tierra del Fuego.txt"
ARU = "countries/Araucania.txt"
VLP = "countries/Valparaiso.txt"
ANT = "countries/Antofagasta.txt"
PBA = "countries/Buenos Aires.txt"
MPL = "countries/Mar del Plata.txt"
JNN = "countries/Junin.txt"
JUJ = "countries/Jujuy.txt"
CHB = "countries/Chaco Boreal.txt"
NEQ = "countries/Neuquen.txt"
CBT = "countries/Chubut.txt"
STC = "countries/Santa Cruz.txt"
RNG = "countries/Rio Negro.txt"
